---W--/-------------------------------------TT---TTTTTTTT--///------------------
------//---------------M-----||----------------TTTTT---////-----------W---------
-------///--------------------------TTTT-----------M-T//------------------------
TTTT----//--N--------TTTT------------------TTTT---TT-///-------TTTT-------------
-T--TTTT-//------------TTT---------|||-------TTTTTT-//---N---------TT---TT--TTT-
--TTT-M---///------------------------||-------TTTTT/-----------TT---TTT----TT---
-------TT---////-TTTTTTTTT---TTTTTTTT-------TTT-///----------TTT-------TTT-TT---
T-TTT----TTT--//-TTT--TTTTTTTT--TTTTTT---TT----/--------------------TT---TT-----
--TTTTTT--N----////---TTT-TTTTTTTTTT--TT---T-//-//-------TT------TT---TT---TTTTT
-TTTT-------------//T---TTTTTTTTT-TT////--///-----//---------TT---TTT---TT----TT
-----------TTT-----//TTTTT--TTTTTT-//---//-----TT---/----------------TT-----TTT-
----TTTTT--T--------//--TTTTTT-T-///-T--TT---------T//--N-------TT---M--TTT-----
---------TTTTT-------/-TTT--/////------------TT-------///-----------------TTTT--
TTTTT---TT---TT------//---///----TT----TTTTT----TT------//------T-------------TT
------TTTT--TT--TTT---////--TTT-----TTTT----TT-----TTT---///--------TTT---------
-------------TT--TTT----/-------TT--------TTTT----TTT------/////----------------
---------TTTT-TTT-------/--------TTTT---T------TTTT--TTTT------///--------------
------------------------//-N--------TT--TTTT-TTT-----------------//////---/////-
-------------------------//--------TTTT---TTT---TTTT------TTTT--------////-----/
--TTT---------------------/---------TTTTT--TTTTT--TTT--TTTT----------/----------
-----------TTT--------W---///-----------TTT---------------------TT---/----------
--------TTTT----------------/------TTTT----------|||--------TTTT----/-----------
------M----TTTT-------------//-------------TT-----|||--------------/------------
-----------------------------//---------------------||--TTT--------/------------
---------||||----||-----------//---N-------------T----------------//------------
-------------||||--------------////---------TTTT------------------/------||||---
------------|-||-||||------------///-----------------------------------M---|----
-----------------------------------///------------------------------------------
-----------------------------M-------////---------------------------------------
----------------------------------------//-----------------TTTT--TTTT-TTT---TT--
-----------------------------------------/////---M----T-----TTTTT------TTT------
----------T-TTTTTT----------------------/----/------------TTT-------TT-----TT---
-------TTT----TTTTTT-----------------///-----///-------TTTT----------W-------TTT
||||-------TTT----TTT-------------///----------///-N-----T-TT-------------------
-|||||--|||------TTTT-------------/--------------///-----------TTT-------TT-----
|----|||----TTTT-------TTT------///----------------//------TTT---------TT----TT-
-----|-|||-------TTTT-------------------------------/////////---TTTT-----TTTT---
|||------------TT------TTTTT--------------------------//----///-----------------
|||||||-------TTTT------TT---------------------------/--------//---N------------
||||||--------------------------------------------///----------////-------------